1111101111
1110100001
1100001101
1101111001
1100000011
1101101011
0000101011
1110111001
1110001101
1111111111